****************************************
****************************************
*                 s                    *
* ***** *** ************************* **
* **    *** **   ************          *
*    ****** ** *              * ***** **
** *********** * ***** ************** **
**                                     *
***** * ****** ***** ************ **** *
***** * **       *** ************ **** *
*****   ************       *           *
*****  ******    ********* * ***** *****
*     ****    ** *    **** * ***** *****
* ********  * ** **** **** * ***** *****
* *   *   * *       * **** * ***** *****
*   *   *   * ***** *      * ***** *****
************* ***** ******** ***** *****
**                                 *****
*******************f********************
